*************************
*	   						 *											*
* *********************	*
* *	  				  *	  		    *	*
* * ***************** *	*	
* * *	   		 *	  		  * *	*
* * * ************* * *	*
* * * *	    *	 		 * * *	*
************0************				
* * * *	    *			  * * *	*
* * * ************* * *	*
* * *	 	   	*	   		 * *	*
* * ***************** * *
* *	   				 *	     		 *	*
* *********************	*			
*	          *											*
*************************
