*************************
*	    *		*
* *********************	*
* *	    *	      *	*
* * ***************** *	*	
* * *	    *	    * *	*
* * * ************* * *	*
* * * *	    *	  * * *	*
************e************				
* * * *	    *	  * * *	*
* * * ************* * *	*
* * *	    *	    * *	*
* * ***************** * *
* *	    *	      *	*
* *********************	*			
*	    *		*
*************************
 
 
 
 
